############    #########
#?S....&..$#    #......?#
#..######.######.###.####
#.##$..$#..&......?#....#
#.#..##.#.###########..##
#.#&##..#.#$#...#&.#..&.#
#&......#....&#.#?#..#..##
#####.####.#.###.#########
    #&#  #.#?#..&#&......#
    #.#  #.###.#.#.#####.#
    #.#  #&....#....#]&..#
    #.#.######..####.....#
    #.#       #.#?...##.##
#####.######  #...#&$$#.#
#....&#.&.##  #&#&#####.#
#.#####.#..#  #.#$$&....#
#.#$.$#.##.####.#######.#
#.#.#.#.#?.#......#...#.#
#.#.#.#.#.##.####.#.#.#.#
#.&?#.&.#....#  #&..#..?#
##############  #########