######## #####
#..&..?# ##??###############
#..##..# ##$$##............]
#..##..# ##??##.############
#..##..# ##&&##.##
#..##..# ##&&##.##
#..##..# ##..##.##
#..##..# ##..##.##
#..##..# ##..##.##
#..##..# ##..##.##
#..##..# ##..##.##
#..##..####..##.##
#S.##..&......&.##
##################