##########     ########
#.....&$?#     #?&....#
#.################.#.##
#.#.&.#.....&....#.#.#####
#.#.#S#.########...#...&.#
#.#.#.#.#      #########.#
#...#..&#       #?$#...#.#
#########       #.&.?#...#
                ########.#
     ##########        #.#
     #.....&..#        #.#
     #.######.#        #.#
     #.?#.&.#.##########.#
     ##.#.#.#........?.&.#
     #&.#.#.##############
     #.##.#?##.]
     #..#.#.&#.#
     #..#.#.##.#
     ##.&.#...&#
     ###########