##############
#S#.&??#.....]
#.#..###.###.#
#......#.&$#$#
#..#...#.#####
#&####&#.#&..#
#?#?$#.#.#?#.#
###..#.#...#.#
#.#..#.#####.#
#....&.......#
##############