           ############       ##########
############.$.##..?..#       #.....####
#$&&&..........##.....#########.##...&$#
#.&S&.........######&&..........##.?...#
###########...#.?.##...##.....##########
          #..&#...##...##....$#
          ###.....&....##..####
            #..###.....##..#
          ###..#...........############
      #####............&####..........]
   ####....&###...#####.........#######
   #........###...#####################
   #..&&&&..###.?.#
####..&$$&..###...#
#?.&..###.........#
###################