##############
#S....&?....?#
#####.#.######
#.$...#.....$#
#.############
#.....&#....$#
###.##.#&#####
#..&......#?$#
#.######..#.&#
#.#?&.#?#..#.#
#.#.#.#$#...&#
#.#.#.#.#.####
#.#.#.#.&.#..#
#.#.#.####&&.]
#...#.&.....##
##############
