#########
#...&..&]
###.#####
#.&...?.#
#.#######
#...S...#
#.#######
#.....&$#
#########